NO ./textures/wolftex/pics/eagle.xpm

SO ./textures/wolftex/pics/greystone.xpm

WE ./textures/wolftex/pics/wood.xpm

EA ./textures/wolftex/pics/colorstone.xpm

F 102,225,102

C 102,225,255


11111111111111111111111111
10000000000000000000100001
10000000000000000000100001
10000000000000000000100001       1111111
10000000000000000000100001       1000W01
10000000010000000000000001       1000001
10000000000000000000000001       1111111
10000000000000000000000001
11111111111111111111111111












