

NO           ./textures/wolftex/pics/eagle.xpm
SO         ./textures/wolftex/pics/greystone.xpm
WE       ./textures/wolftex/pics/wood.xpm




EA           ./textures/wolftex/pics/colorstone.xpm 

F           102,     225,102
C             102,225,255



 11111111111111111111111111
 10000000000000000000100001
 1000000000000000000010011 
 10000000000000000000111
 11111111111111111111
 100000000000E000000011 
 100000000100000000000111111111                                                 
 10000000000000000000000001
 10000000000000000000000001
 10001111111111111111110001
 111111             1111111