NO ./textures/minecraft/dirt.xpm

SO ./textures/minecraft/stone.xpm

WE ./textures/minecraft/wood.xpm

EA ./textures/minecraft/gravel.xpm

F              102,225,102

C 102,225,255

        11111111111111111111
        1111111111111111111111111
        1000000000110000000000001
        1011000001110000000000001
        1001000000000000000000001
111111111011000001110000000000001
100000000011010001110111111111111
111101111111110111000000100011111
11110111111111011101010010001
11000000110101011100000010001111
10000000000000001100E00010001
10000000000000001101010010001
1100000111010101111101111000111
11110111 1110101 101011010001
11111111 1111111 111111111111